##########
#X#      #
### C    #
#        #
#        #
#    E   #
#E       #
#  C     #
#        #
##########